BOMBS-AWAY

11 18 3 0 0
9 9 9 9 9 9 9 9 9 9 9 9 9 9 9 9 9 9
9 0 0 0 0 0 0 0 0 0 0 0 0 0 0 0 0 9
9 0 0 0 0 0 0 0 0 1 0 0 0 0 0 0 0 9
9 0 0 0 0 1 0 0 0 0 0 0 0 0 0 0 0 9
9 0 0 0 0 0 0 0 0 0 0 0 0 0 0 0 0 9
9 0 0 3 0 0 0 0 7 0 6 0 0 0 1 0 0 9
9 0 0 0 0 0 0 0 0 1 0 0 0 0 0 0 0 9
9 0 0 0 0 0 0 0 0 0 0 0 0 2 0 0 0 9
9 0 0 0 0 0 1 0 0 0 0 0 0 0 0 0 0 9
9 0 0 0 0 0 0 0 0 0 0 0 0 0 0 0 0 9
9 9 9 9 9 9 9 9 9 9 9 9 9 9 9 9 9 9

14 19 6 0 0
9 9 9 9 9 9 9 9 9 9 9 9 9 9 9 9 9 9 9
9 0 0 0 0 0 0 0 0 0 0 0 0 0 0 0 0 0 9
9 0 0 0 0 0 0 0 0 0 0 0 3 0 0 0 0 0 9
9 0 0 0 0 0 0 0 0 0 0 0 0 0 0 0 0 0 9
9 0 0 0 1 0 0 0 0 0 0 0 0 0 1 0 0 0 9
9 0 0 0 0 6 0 0 0 1 0 6 7 0 0 0 0 0 9
9 0 0 0 7 0 0 0 0 0 0 0 0 0 0 0 0 0 9
9 0 0 0 0 0 0 0 0 0 0 0 0 0 0 0 0 0 9
9 0 0 0 0 0 0 0 0 2 0 0 0 0 0 0 0 0 9
9 0 0 0 0 0 0 0 1 0 1 0 0 0 0 0 0 0 9
9 0 0 1 0 0 0 0 0 0 0 6 0 0 0 1 0 0 9
9 0 0 0 0 0 0 0 0 0 0 0 1 0 0 0 0 0 9
9 0 0 0 0 0 0 0 0 0 0 0 0 0 0 0 0 0 9
9 9 9 9 9 9 9 9 9 9 9 9 9 9 9 9 9 9 9

17 18 7 0 0
9 9 9 9 9 9 9 9 9 9 9 9 9 9 9 9 9 9
9 0 0 0 0 0 0 0 0 0 0 0 0 0 0 0 0 9
9 0 0 0 0 0 0 0 0 0 0 0 0 0 1 0 0 9
9 0 0 0 1 0 0 0 0 0 0 0 0 0 0 0 0 9
9 0 0 0 0 0 0 0 1 0 0 0 0 0 0 0 0 9
9 0 0 0 0 0 0 0 0 0 0 6 0 0 0 0 0 9
9 0 0 0 0 1 6 0 0 0 0 0 0 0 3 0 0 9
9 0 0 0 0 0 0 0 0 0 0 0 0 0 0 0 0 9
9 0 0 0 0 0 0 0 0 0 0 0 0 0 0 0 0 9
9 0 0 0 0 0 0 0 0 0 0 0 0 0 0 0 0 9
9 0 0 0 0 0 2 0 0 0 0 0 0 0 0 0 0 9
9 0 0 1 0 0 0 7 0 0 0 0 0 0 0 0 0 9
9 0 0 0 0 0 0 0 0 0 0 0 0 0 1 0 0 9
9 0 0 0 0 0 0 0 0 0 0 0 1 0 0 0 0 9
9 0 0 0 0 0 0 1 0 0 0 0 0 0 0 0 0 9
9 0 0 0 0 0 0 0 0 0 0 0 0 0 0 0 0 9
9 9 9 9 9 9 9 9 9 9 9 9 9 9 9 9 9 9

15 19 6 0 0
9 9 9 9 9 9 9 9 9 9 9 9 9 9 9 9 9 9 9
9 0 0 0 0 0 0 0 0 0 0 0 0 0 0 0 0 0 9
9 0 0 0 0 0 0 0 0 0 0 1 0 0 0 0 0 0 9
9 0 0 0 0 0 0 1 0 0 0 0 0 1 0 0 0 0 9
9 0 0 0 0 0 0 0 0 2 0 0 0 0 0 0 0 0 9
9 0 0 0 0 0 0 0 0 0 0 0 1 0 0 0 0 0 9
9 0 0 0 0 0 0 0 3 0 0 0 0 0 0 0 0 0 9
9 0 0 0 1 0 0 0 0 0 0 0 0 0 0 0 0 0 9
9 0 0 0 0 0 0 0 0 0 0 0 0 0 1 0 0 0 9
9 0 0 0 0 0 6 0 0 0 6 0 0 0 0 0 0 0 9
9 0 0 0 0 0 0 0 0 0 0 0 0 0 0 0 0 0 9
9 0 0 1 0 0 0 0 0 0 0 7 0 0 0 1 0 0 9
9 0 0 0 0 0 0 0 1 0 0 0 0 0 0 0 0 0 9
9 0 0 0 0 0 0 0 0 0 0 0 0 0 0 0 0 0 9
9 9 9 9 9 9 9 9 9 9 9 9 9 9 9 9 9 9 9

13 15 9 0 0
9 9 9 9 9 9 9 9 9 9 9 9 9 9 9
9 0 0 0 0 0 0 0 0 0 0 0 0 0 9
9 0 0 0 0 1 0 0 0 0 0 0 0 0 9
9 0 0 0 0 0 0 0 0 0 6 0 0 0 9
9 0 0 0 6 0 0 0 0 0 0 0 0 0 9
9 0 0 0 0 0 0 0 2 1 0 0 0 0 9
9 0 0 0 0 7 0 0 0 0 0 0 0 0 9
9 0 0 0 0 0 0 0 0 0 0 0 0 0 9
9 0 0 0 0 3 0 0 0 0 0 6 0 0 9
9 0 0 1 0 6 0 0 0 0 0 0 0 0 9
9 0 0 0 0 0 0 0 0 0 1 0 0 0 9
9 0 0 0 0 0 0 0 0 0 0 0 0 0 9
9 9 9 9 9 9 9 9 9 9 9 9 9 9 9

12 20 8 0 0
9 9 9 9 9 9 9 9 9 9 9 9 9 9 9 9 9 9 9 9
9 0 0 0 0 0 0 0 0 0 0 0 0 0 0 0 0 0 0 9
9 0 0 0 0 0 0 0 0 1 0 0 0 0 0 0 0 0 0 9
9 0 0 0 0 0 0 0 0 0 0 0 0 0 0 1 0 0 0 9
9 0 0 0 1 0 0 0 0 6 0 0 0 0 0 0 0 0 0 9
9 0 0 0 0 0 7 0 0 0 0 1 0 0 0 0 0 0 0 9
9 0 0 0 0 0 0 0 0 0 0 0 0 0 2 0 0 0 0 9
9 0 0 0 0 0 0 0 1 0 0 0 0 0 0 0 1 0 0 9
9 0 0 1 0 0 0 3 0 0 1 0 0 0 0 0 0 0 0 9
9 0 0 0 0 0 0 0 0 0 0 0 0 0 0 1 0 0 0 9
9 0 0 0 0 0 0 0 0 0 0 0 0 0 0 0 0 0 0 9
9 9 9 9 9 9 9 9 9 9 9 9 9 9 9 9 9 9 9 9

15 19 8 0 0
9 9 9 9 9 9 9 9 9 9 9 9 9 9 9 9 9 9 9
9 0 0 0 0 0 0 0 0 0 0 0 0 0 0 0 0 0 9
9 0 0 0 0 0 0 1 0 0 0 0 0 0 0 0 0 0 9
9 0 0 0 1 0 1 0 0 0 0 7 0 0 3 1 0 0 9
9 0 0 0 0 0 0 0 6 0 0 0 0 1 0 0 0 0 9
9 0 0 0 0 1 0 0 0 0 0 0 0 0 0 0 0 0 9
9 0 0 0 0 0 0 0 0 0 0 0 0 0 0 0 0 0 9
9 0 0 0 0 0 0 0 0 0 0 0 2 0 0 0 0 0 9
9 0 0 0 0 0 0 0 0 0 0 0 0 0 0 0 0 0 9
9 0 0 0 0 0 0 0 0 0 0 0 0 6 0 0 0 0 9
9 0 0 1 0 0 6 7 0 0 0 0 0 0 0 0 0 0 9
9 0 0 0 0 0 0 0 0 0 0 0 0 0 1 0 0 0 9
9 0 0 0 0 0 0 1 0 0 0 0 0 0 0 0 0 0 9
9 0 0 0 0 0 0 0 0 0 0 0 0 0 0 0 0 0 9
9 9 9 9 9 9 9 9 9 9 9 9 9 9 9 9 9 9 9

15 17 7 0 0
9 9 9 9 9 9 9 9 9 9 9 9 9 9 9 9 9
9 0 0 0 0 0 0 0 0 0 0 0 0 0 0 0 9
9 0 0 0 0 0 0 0 0 0 0 0 1 0 0 0 9
9 0 0 0 1 0 0 0 0 0 0 0 0 0 0 0 9
9 0 0 0 0 7 0 0 0 0 0 0 0 1 0 0 9
9 0 0 0 0 0 0 0 0 0 0 6 0 0 0 0 9
9 0 0 0 0 0 0 0 2 0 0 0 0 0 0 0 9
9 0 0 0 0 0 0 0 0 0 0 0 0 1 0 0 9
9 0 0 0 0 6 0 0 0 0 0 0 0 0 0 0 9
9 0 0 0 0 0 0 0 0 0 0 0 0 0 0 0 9
9 0 0 1 0 0 0 0 0 0 0 0 3 0 0 0 9
9 0 0 0 0 0 0 0 0 0 0 0 1 0 0 0 9
9 0 0 0 0 1 0 0 0 0 0 0 0 0 0 0 9
9 0 0 0 0 0 0 0 0 0 0 0 0 0 0 0 9
9 9 9 9 9 9 9 9 9 9 9 9 9 9 9 9 9

14 21 7 0 0
9 9 9 9 9 9 9 9 9 9 9 9 9 9 9 9 9 9 9 9 9
9 0 0 0 0 0 0 0 0 0 0 0 0 0 0 0 0 0 0 0 9
9 0 0 0 0 0 0 0 0 0 0 0 0 0 0 1 0 0 0 0 9
9 0 0 0 0 0 0 0 0 1 0 0 0 0 0 0 0 0 0 0 9
9 0 0 0 0 0 1 0 0 0 0 0 3 0 0 0 0 1 0 0 9
9 0 0 0 1 0 0 0 0 0 0 0 0 0 0 0 0 0 0 0 9
9 0 0 0 0 0 0 7 0 0 2 0 0 0 0 0 0 0 0 0 9
9 0 0 0 0 0 0 0 0 0 0 0 0 0 0 0 0 0 0 0 9
9 0 0 0 0 0 0 0 0 0 0 0 0 0 0 6 0 0 0 0 9
9 0 0 1 0 0 0 0 6 0 0 0 0 0 0 0 0 0 0 0 9
9 0 0 0 0 0 0 0 0 0 0 0 0 0 0 0 1 0 0 0 9
9 0 0 0 0 0 0 1 0 0 0 0 0 0 0 0 0 0 0 0 9
9 0 0 0 0 0 0 0 0 0 0 0 0 0 0 0 0 0 0 0 9
9 9 9 9 9 9 9 9 9 9 9 9 9 9 9 9 9 9 9 9 9

15 17 9 0 0
9 9 9 9 9 9 9 9 9 9 9 9 9 9 9 9 9
9 0 0 0 0 0 0 0 0 0 0 0 0 0 0 0 9
9 0 0 0 0 0 0 1 0 0 0 0 0 0 0 0 9
9 0 0 0 0 0 0 0 0 0 0 0 1 0 0 0 9
9 0 0 0 1 0 0 6 0 0 0 0 0 0 0 0 9
9 0 0 0 0 0 0 0 0 0 0 0 0 1 0 0 9
9 0 0 0 0 0 0 0 0 0 0 0 0 0 0 0 9
9 0 0 0 0 0 0 7 0 0 0 0 7 0 0 0 9
9 0 0 0 0 0 0 0 1 0 0 0 0 0 0 0 9
9 0 0 2 0 0 6 3 0 0 0 0 0 1 0 0 9
9 0 0 0 0 0 0 0 0 1 0 0 0 0 0 0 9
9 0 0 0 0 1 0 0 0 0 0 0 1 0 0 0 9
9 0 0 0 0 0 0 0 0 0 1 0 0 0 0 0 9
9 0 0 0 0 0 0 0 0 0 0 0 0 0 0 0 9
9 9 9 9 9 9 9 9 9 9 9 9 9 9 9 9 9