CLASSIC

10 10 5 7 8 0
1 1 1 1 1 1 1 1 1 1 
1 9 9 1 0 0 0 0 0 1 
1 9 0 0 0 0 2 0 0 1 
1 1 0 0 0 1 0 0 0 1 
1 9 1 0 0 0 0 0 0 1 
1 0 0 0 0 0 1 3 0 1 
1 0 0 0 1 0 0 0 0 1 
1 0 1 0 0 0 0 0 0 1 
1 0 0 0 0 0 0 0 0 1 
1 1 1 1 1 1 1 1 1 1

12 14 6 6 5 0
9 9 9 9 9 9 9 9 9 9 9 9 9 9 
9 0 0 0 0 1 0 0 0 0 0 0 0 9 
9 0 0 0 0 0 0 0 0 0 1 0 0 9 
9 0 0 0 0 0 1 0 1 0 0 0 0 9 
9 0 0 0 1 0 0 0 0 0 0 0 0 9 
9 0 0 0 0 0 0 2 0 1 0 0 0 9 
9 0 1 0 0 0 3 0 0 0 0 1 0 9 
9 0 0 0 0 0 0 0 0 0 0 0 0 9 
9 0 0 0 0 1 0 0 0 0 1 0 0 9 
9 0 0 1 0 0 0 0 0 0 0 0 0 9 
9 1 0 0 0 0 0 0 0 0 0 0 0 9 
9 9 9 9 9 9 9 9 9 9 9 9 9 9

14 14 2 6 6 0
9 9 9 1 9 9 9 9 9 1 9 9 9 9 
9 1 0 0 0 0 0 0 0 0 0 0 0 9 
9 0 0 0 1 0 3 0 0 0 0 1 0 9 
9 0 0 0 0 0 0 0 0 0 0 0 0 9 
9 0 0 0 0 9 0 0 0 0 0 0 1 9 
9 0 0 0 0 0 0 2 0 0 0 0 0 9 
9 0 0 1 0 1 0 0 0 0 0 0 0 9 
9 0 0 0 0 0 0 9 0 0 0 0 0 9 
9 0 0 0 0 0 0 0 1 0 0 0 0 9 
1 0 0 0 0 0 0 0 0 0 1 0 0 9 
9 0 1 0 0 0 1 0 0 0 0 0 0 1 
9 0 0 0 0 0 0 0 0 0 0 0 0 9 
9 0 0 0 0 0 1 0 0 0 0 0 0 9 
9 1 9 9 9 9 9 9 9 1 9 9 9 9	

13 18 10 2 10 0
1 1 1 1 1 1 1 1 1 1 1 1 1 1 1 1 1 1 
1 0 0 0 0 0 0 9 1 0 0 1 0 0 0 0 0 1 
1 0 0 1 1 0 0 0 0 0 0 0 0 0 0 0 0 1 
1 0 0 0 0 0 0 0 0 0 0 0 0 0 0 1 0 1 
1 0 0 0 0 2 0 0 0 0 0 0 0 0 0 0 0 1 
1 0 0 0 0 0 0 0 1 0 0 0 0 1 0 0 0 1 
1 0 1 0 0 0 0 0 0 0 1 0 0 0 0 1 0 1 
1 0 0 0 0 1 0 0 0 0 0 0 0 0 0 0 0 1 
1 0 0 0 0 0 0 0 0 0 0 0 0 0 1 0 0 1 
1 0 0 1 0 0 0 0 0 0 0 0 0 0 0 0 0 1 
1 0 3 0 0 0 0 0 0 1 0 0 0 0 0 0 0 1 
1 0 0 0 0 0 0 0 0 0 0 0 0 0 0 0 0 1 
1 1 1 1 1 1 1 1 1 1 1 1 1 1 1 1 1 1

15 21 2 13 17 0
1 1 1 1 1 1 1 1 1 1 1 1 1 1 1 1 1 1 1 1 1 
1 0 0 1 1 0 0 0 0 0 0 0 1 0 0 0 0 0 0 0 1 
1 0 0 0 0 0 0 0 0 1 0 0 0 3 1 0 0 1 0 0 1 
1 0 0 0 0 0 0 0 0 0 0 0 0 0 0 0 0 0 0 0 1 
1 1 0 0 0 0 0 0 1 0 0 0 0 0 0 0 1 0 0 0 1 
1 0 1 0 1 0 0 0 0 0 0 0 0 0 0 0 0 0 0 0 1 
1 0 0 0 0 0 0 0 0 0 0 0 0 1 0 0 0 0 0 0 1 
1 0 0 0 0 0 0 0 0 0 0 0 0 0 0 0 0 1 0 0 1 
1 0 0 0 0 1 0 0 0 0 0 1 0 0 0 0 0 0 0 0 1 
1 0 0 1 0 0 0 0 0 0 0 0 0 0 0 0 0 1 0 0 1 
1 0 0 0 0 0 0 0 0 1 0 0 0 0 0 1 0 0 0 0 1 
1 0 0 0 0 1 0 0 0 0 0 0 1 0 0 0 0 0 0 0 1 
1 0 2 0 0 0 0 0 0 0 1 0 0 0 0 0 0 0 1 0 1 
1 0 1 0 0 0 0 1 0 0 0 0 0 0 1 0 0 0 0 0 1 
1 1 1 1 1 1 1 1 1 1 1 1 1 1 1 1 1 1 1 1 1

13 16 8 11 6 0
9 9 9 9 9 9 9 9 9 9 9 9 9 9 9 9 
9 0 0 0 0 0 1 0 0 0 0 0 0 0 0 9 
9 0 0 0 0 0 0 0 2 0 0 0 0 0 0 9 
9 0 0 0 0 0 0 0 0 0 0 1 0 0 0 9 
9 0 0 0 1 0 0 0 0 0 0 0 0 0 0 9 
9 0 1 0 0 0 0 0 0 0 0 0 0 1 0 9 
9 0 0 0 0 0 0 1 0 0 0 0 0 0 0 9 
9 0 0 0 0 0 0 0 0 0 0 0 1 0 0 9 
9 0 0 1 0 0 0 0 0 0 0 3 0 0 0 9 
9 0 0 0 0 0 0 0 1 0 0 0 0 0 0 9 
9 0 0 0 0 1 0 0 0 0 0 1 0 0 0 9 
9 0 0 0 0 0 0 0 0 0 0 0 0 0 0 9 
9 9 9 9 9 9 9 9 9 9 9 9 9 9 9 9
		
13 16 9 6 11 0
9 9 9 9 9 9 9 9 9 9 9 9 9 9 9 9 
9 0 0 0 0 0 0 0 0 0 0 0 0 0 0 9 
9 0 0 0 0 0 0 0 0 0 1 0 0 0 0 9 
9 0 0 0 1 0 0 0 0 0 0 0 0 0 0 9 
9 0 0 0 0 0 0 0 0 0 8 0 1 0 0 9 
9 0 0 0 0 0 2 0 0 0 0 0 0 0 0 9 
9 0 0 0 0 0 0 0 0 8 0 0 0 0 0 9 
9 0 0 1 0 0 8 0 0 0 0 1 0 0 0 9 
9 0 0 0 0 0 0 0 0 0 0 0 0 0 0 9 
9 0 0 1 0 0 3 0 0 0 1 0 0 0 0 9 
9 0 0 0 0 1 0 0 0 0 0 0 0 0 0 9 
9 0 0 0 0 0 0 0 0 0 0 0 0 0 0 9 
9 9 9 9 9 9 9 9 9 9 9 9 9 9 9 9

16 23 3 12 26 0
9 9 9 9 9 9 9 9 9 9 9 9 9 9 9 9 9 9 9 9 9 9 9 
9 0 0 0 0 0 0 0 0 0 0 0 0 0 0 0 0 0 0 0 0 0 9 
9 0 0 0 0 0 0 0 0 1 0 0 0 0 0 0 0 0 0 0 0 0 9 
9 0 0 0 0 0 0 8 0 0 0 0 3 0 0 0 0 8 0 0 0 0 9 
9 0 0 0 0 0 0 0 0 0 0 0 0 0 0 0 0 0 0 0 0 0 9 
9 0 0 0 0 0 0 0 0 0 1 9 1 9 1 0 0 0 0 8 0 0 9 
9 0 0 0 1 0 0 0 0 0 9 0 2 0 9 0 0 0 0 0 0 0 9 
9 0 0 0 0 0 0 0 0 0 0 8 8 8 0 0 0 0 0 0 0 0 9 
9 0 0 8 0 1 0 0 0 0 0 0 0 0 0 0 0 0 0 0 0 0 9 
9 0 0 0 0 0 0 0 0 0 1 0 0 0 0 0 0 0 0 1 0 0 9 
9 0 0 0 8 0 0 0 0 0 0 8 0 0 1 0 0 0 0 0 0 0 9 
9 0 0 8 0 0 0 0 0 0 0 0 0 0 0 0 0 0 0 0 0 0 9 
9 0 0 1 0 0 0 0 0 0 0 8 0 8 0 0 0 0 0 1 0 0 9 
9 0 0 0 0 0 0 1 0 0 0 1 0 1 0 0 0 1 0 0 0 0 9 
9 0 0 0 0 0 0 0 0 0 0 0 0 0 0 0 0 0 0 0 0 0 9 
9 9 9 9 9 9 9 9 9 9 9 9 9 9 9 9 9 9 9 9 9 9 9

14 16 7 6 10 1
9 9 9 9 9 9 9 9 9 9 9 9 9 9 9 9 
9 0 0 0 0 0 0 0 0 0 0 0 0 0 0 9 
9 0 0 0 0 0 9 0 0 0 0 0 0 0 0 9 
9 0 0 0 0 0 0 0 0 0 1 0 0 0 0 9 
9 0 0 0 0 1 0 0 0 0 0 8 0 0 0 9 
9 0 0 8 0 0 0 0 9 0 0 0 0 0 0 9 
9 0 0 0 0 0 8 0 0 0 0 8 0 0 0 9 
9 0 0 0 0 0 3 0 0 0 0 0 1 0 0 9 
9 0 0 0 0 0 0 8 0 2 0 0 0 0 0 9 
9 0 0 0 1 0 0 0 0 0 0 0 0 0 0 9 
9 0 0 8 0 0 0 0 0 0 0 1 0 0 0 9 
9 0 0 0 0 0 1 0 0 0 0 0 0 0 0 9 
9 0 0 0 0 0 0 0 0 0 0 0 0 0 0 9 
9 9 9 9 9 9 9 9 9 9 9 9 9 9 9 9

17 19 8 9 27 0
9 9 9 9 9 9 9 9 9 9 9 9 9 9 9 9 9 9 9 
9 0 0 0 0 0 0 0 0 0 0 0 0 0 0 0 0 0 9 
9 0 0 0 0 0 0 0 1 0 1 0 0 0 0 8 0 0 9 
9 0 0 0 0 0 8 0 0 0 0 0 1 0 0 0 0 0 9 
9 0 0 0 0 8 0 0 0 0 0 1 0 0 0 8 0 0 9 
9 0 0 0 0 0 0 0 0 1 9 0 0 0 0 8 0 0 9 
9 0 0 0 1 0 0 0 0 0 0 0 0 1 0 0 0 0 9 
9 0 0 0 0 0 0 0 1 0 0 0 0 0 0 0 0 0 9 
9 0 0 1 0 0 0 0 0 3 0 0 0 0 1 0 0 0 9 
9 0 0 0 0 8 0 0 0 0 2 0 0 0 0 0 0 0 9 
9 0 0 0 0 9 0 0 0 0 0 0 0 0 0 8 0 0 9 
9 0 0 0 0 0 9 0 0 0 0 0 0 0 8 0 0 0 9 
9 0 0 8 0 0 0 0 0 0 0 0 8 1 0 0 0 0 9 
9 0 0 8 0 0 0 1 0 8 0 0 0 0 0 0 0 0 9 
9 0 0 0 1 0 0 0 9 0 0 0 0 0 8 0 0 0 9 
9 0 0 0 0 0 0 0 0 0 0 0 0 0 0 0 0 0 9 
9 9 9 9 9 9 9 9 9 9 9 9 9 9 9 9 9 9 9
